电影 simility list : 电影 影片 动画
美食 simility list : 美食
汽车 simility list : 汽车
做法 simility list : 做法
军事 simility list : 军事
简单 simility list : 简单 详细
新闻 simility list : 新闻 快讯
比赛 simility list : 比赛
影片 simility list : 电影 影片 动画
推荐 simility list : 推荐
预告 simility list : 预告
近日 simility list : 近日
球队 simility list : 球队
惊 simility list : 惊
超级 simility list : 超级
日常 simility list : 日常
海军 simility list : 海军 空军 军队 陆军 政府军 联军 我军
球员 simility list : 球员 投手
汁 simility list : 汁
早餐 simility list : 早餐
记者 simility list : 记者
空军 simility list : 海军 空军 政府军 联军 我军
赶紧 simility list : 赶紧
上映 simility list : 上映
综艺 simility list : 综艺
讲述 simility list : 讲述
歼 simility list : 歼
冠军 simility list : 冠军
联赛 simility list : 联赛
俱乐部 simility list : 俱乐部
口感 simility list : 口感
导弹 simility list : 导弹 火箭
文章 simility list : 文章
行业 simility list : 行业
剧情 simility list : 剧情
战斗机 simility list : 战斗机 驱逐舰 坦克 航母 舰船 舰艇 军舰 潜艇 核潜艇
战机 simility list : 战机
煮 simility list : 煮 焖 煸 炖
节目 simility list : 节目
人工智能 simility list : 人工智能 科技
企业 simility list : 企业 店
地址 simility list : 地址
动画 simility list : 电影 影片 动画
现场 simility list : 现场
成都 simility list : 成都
数据 simility list : 数据
直播 simility list : 直播
美军 simility list : 美军
历史 simility list : 历史
发现 simility list : 发现
晚会 simility list : 晚会
驱逐舰 simility list : 战斗机 驱逐舰 核潜艇
长征 simility list : 长征
发布 simility list : 发布
法院 simility list : 法院 警方 公安局
球场 simility list : 球场
事故 simility list : 事故
坦克 simility list : 战斗机 坦克
牛奶 simility list : 牛奶
情况 simility list : 情况
手机 simility list : 手机
公司 simility list : 公司
口碑 simility list : 口碑
店 simility list : 企业 店
娱乐 simility list : 娱乐
警方 simility list : 法院 警方 公安局
军人 simility list : 军人 士兵
博物馆 simility list : 博物馆 博物院
短片 simility list : 短片
医院 simility list : 医院
司机 simility list : 司机 飞行员
人员 simility list : 人员
奥斯卡 simility list : 奥斯卡
第十一 simility list : 第十一
对手 simility list : 对手
市场 simility list : 市场
舟 simility list : 舟
期待 simility list : 期待 希望
队友 simility list : 队友
球迷 simility list : 球迷
车辆 simility list : 车辆
蛋糕 simility list : 蛋糕 饼干
菜谱 simility list : 菜谱
昨日 simility list : 昨日 今日
碗 simility list : 碗
台风 simility list : 台风
犯罪 simility list : 犯罪
性能 simility list : 性能
凌晨 simility list : 凌晨
航母 simility list : 战斗机 航母 核潜艇
萨 simility list : 萨
创业 simility list : 创业
真实 simility list : 真实
政府 simility list : 政府
部队 simility list : 部队
驾 simility list : 驾 驾驶
爸爸 simility list : 爸爸 母亲 妈妈
身亡 simility list : 身亡
军队 simility list : 海军 军队
受贿 simility list : 受贿
观众 simility list : 观众
作品 simility list : 作品
演员 simility list : 演员 艺人
买 simility list : 买
飞行 simility list : 飞行
武器 simility list : 武器
编队 simility list : 编队
艘 simility list : 艘
文物 simility list : 文物 超导体
嘉宾 simility list : 嘉宾
天籁 simility list : 天籁
小米 simility list : 小米
书记 simility list : 书记 员工
技术 simility list : 技术
球星 simility list : 球星
决赛 simility list : 决赛
全程 simility list : 全程
甜品 simility list : 甜品
虾 simility list : 虾
试试 simility list : 试试
四川 simility list : 四川
解放军 simility list : 解放军
舰船 simility list : 战斗机 舰船 舰艇 军舰
舰 simility list : 舰
颁奖 simility list : 颁奖
位于 simility list : 位于
周五 simility list : 周五 周四 周六
执导 simility list : 执导
平台 simility list : 平台
政策 simility list : 政策
曝光 simility list : 曝光
发布会 simility list : 发布会
乾隆 simility list : 乾隆
受伤 simility list : 受伤
机会 simility list : 机会 时光
人均 simility list : 人均
创新 simility list : 创新
时期 simility list : 时期 时代 时光
梦 simility list : 梦
红军 simility list : 红军
士兵 simility list : 军人 士兵
部署 simility list : 部署
浙江 simility list : 浙江
芒果 simility list : 芒果
类 simility list : 类
责任 simility list : 责任
地图 simility list : 地图 图片
妻子 simility list : 妻子 丈夫 老婆
制药 simility list : 制药
总统 simility list : 总统 队长 市长 院长 主任 总理 负责人
新华社 simility list : 新华社
少女 simility list : 少女
学校 simility list : 学校
特色 simility list : 特色
加盟 simility list : 加盟
智能 simility list : 智能
部门 simility list : 部门
演技 simility list : 演技
灯 simility list : 灯
确实 simility list : 确实
省委 simility list : 省委
录制 simility list : 录制
战士 simility list : 战士 新兵
飞船 simility list : 飞船
评分 simility list : 评分
终极 simility list : 终极
人物 simility list : 人物
建立 simility list : 建立
资源 simility list : 资源
周一 simility list : 周一
对阵 simility list : 对阵
女排 simility list : 女排
播出 simility list : 播出
电视剧 simility list : 电视剧
距离 simility list : 距离
秋天 simility list : 秋天
焖 simility list : 煮 焖 煸 炖
饺子 simility list : 饺子
豆腐 simility list : 豆腐 鸡肉 牛肉
女神 simility list : 女神
厨房 simility list : 厨房
森林 simility list : 森林
错过 simility list : 错过
引擎 simility list : 引擎 内存 发动机
年货 simility list : 年货 产品
生命 simility list : 生命
区 simility list : 区 国家
奔驰 simility list : 奔驰
寻 simility list : 寻
起飞 simility list : 起飞
上午 simility list : 上午
哥哥 simility list : 哥哥 哥
南京 simility list : 南京
分钟 simility list : 分钟
动物 simility list : 动物
夜 simility list : 夜
登陆 simility list : 登陆
老板 simility list : 老板
飞机 simility list : 飞机
地区 simility list : 地区 地域
哭 simility list : 哭
可爱 simility list : 可爱
太空 simility list : 太空
详 simility list : 详
调查 simility list : 调查
早安 simility list : 早安
过瘾 simility list : 过瘾
咯 simility list : 咯
产业 simility list : 产业
朋友 simility list : 朋友 情侣 好友
鞋 simility list : 鞋
产品 simility list : 年货 产品
公里 simility list : 公里
鸡蛋 simility list : 鸡蛋
数量 simility list : 数量
驾驶 simility list : 驾 驾驶
遭 simility list : 遭
赶到 simility list : 赶到 前往
公园 simility list : 公园
父母 simility list : 父母 家长
国家 simility list : 区 国家 县
出席 simility list : 出席
联合 simility list : 联合
二战 simility list : 二战
县 simility list : 国家 县
青岛 simility list : 青岛
挑战 simility list : 挑战
长沙 simility list : 长沙
导致 simility list : 导致 引发
快速 simility list : 快速
皇 simility list : 皇
小区 simility list : 小区
马路 simility list : 马路
群众 simility list : 群众 人群 公众
家长 simility list : 父母 家长
执行 simility list : 执行 实施
音乐 simility list : 音乐
管理 simility list : 管理
环境 simility list : 环境
空间 simility list : 空间 星空
未 simility list : 未 勿
背景 simility list : 背景
战争 simility list : 战争
采访 simility list : 采访
员工 simility list : 书记 员工
科技 simility list : 人工智能 科技 考古
主席 simility list : 主席 主持人 队长 市长 院长 主任 负责人
句 simility list : 句
违法 simility list : 违法
紧急 simility list : 紧急
珠海 simility list : 珠海
海报 simility list : 海报
离开 simility list : 离开
专辑 simility list : 专辑
新兵 simility list : 战士 新兵
下午 simility list : 下午 中午
详细 simility list : 简单 详细
方向 simility list : 方向
主持人 simility list : 主席 主持人
转型 simility list : 转型
学生 simility list : 学生 主教练 老师
票房 simility list : 票房
机械师 simility list : 机械师
丽 simility list : 丽
现象 simility list : 现象
诚 simility list : 诚
地铁 simility list : 地铁
想象 simility list : 想象
枚 simility list : 枚
作者 simility list : 作者
案件 simility list : 案件
哥 simility list : 哥哥 哥
希望 simility list : 期待 希望
事情 simility list : 事情 事件
重庆 simility list : 重庆
主场 simility list : 主场
射门 simility list : 射门
战胜 simility list : 战胜
夺冠 simility list : 夺冠
助攻 simility list : 助攻
说道 simility list : 说道
萌 simility list : 萌
北美 simility list : 北美
烘焙 simility list : 烘焙
开胃 simility list : 开胃
清香 simility list : 清香
午餐 simility list : 午餐
鸡肉 simility list : 豆腐 鸡肉
麻辣 simility list : 麻辣
探索 simility list : 探索
服务 simility list : 服务
尾 simility list : 尾
底盘 simility list : 底盘
车型 simility list : 车型
斯 simility list : 斯
沈阳 simility list : 沈阳
报警 simility list : 报警
舰艇 simility list : 战斗机 舰船 舰艇 军舰
之间 simility list : 之间
当地时间 simility list : 当地时间
正式 simility list : 正式
西安 simility list : 西安
酷 simility list : 酷
少年 simility list : 少年
口味 simility list : 口味 兴趣
海 simility list : 海
周四 simility list : 周五 周四 周六
香蕉 simility list : 香蕉
可口 simility list : 可口 鲜美
拌 simility list : 拌
投资 simility list : 投资
恋 simility list : 恋 喜爱
圆梦 simility list : 圆梦
好莱坞 simility list : 好莱坞
角色 simility list : 角色
金融 simility list : 金融
跑车 simility list : 跑车
博物院 simility list : 博物馆 博物院
皇后 simility list : 皇后
片段 simility list : 片段
论坛 simility list : 论坛
合同 simility list : 合同
密码 simility list : 密码
表达 simility list : 表达 指出
牛肉 simility list : 豆腐 牛肉
天天 simility list : 天天
方法 simility list : 方法 措施 办法
家里 simility list : 家里
代码 simility list : 代码
人性 simility list : 人性
家人 simility list : 家人
队长 simility list : 总统 主席 队长 市长 院长 主任 总理 负责人
日前 simility list : 日前
杭州 simility list : 杭州
上海 simility list : 上海
力量 simility list : 力量
前往 simility list : 赶到 前往
周六 simility list : 周五 周四 周六
判处 simility list : 判处
甘肃 simility list : 甘肃
获悉 simility list : 获悉
疾病 simility list : 疾病
赔偿 simility list : 赔偿
工人 simility list : 工人 艺人
市委 simility list : 市委
市民 simility list : 市民 居民
死刑 simility list : 死刑
救人 simility list : 救人 救命
丈夫 simility list : 妻子 丈夫 老婆
走失 simility list : 走失
救命 simility list : 救人 救命
安徽 simility list : 安徽
污染 simility list : 污染
天气 simility list : 天气
政治 simility list : 政治
实力 simility list : 实力
系列 simility list : 系列
资讯 simility list : 资讯 信息 消息
超过 simility list : 超过
陆军 simility list : 海军 陆军 政府军 联军 我军
军官 simility list : 军官
我国 simility list : 我国
显示 simility list : 显示
网上 simility list : 网上
阵容 simility list : 阵容
猫 simility list : 猫
起诉 simility list : 起诉
审理 simility list : 审理
开庭 simility list : 开庭
乘客 simility list : 乘客 游客
排名 simility list : 排名
车身 simility list : 车身
蒋介石 simility list : 蒋介石
民 simility list : 民
姐姐 simility list : 姐姐
久 simility list : 久
呼和浩特 simility list : 呼和浩特
扶贫 simility list : 扶贫
报名 simility list : 报名
时代 simility list : 时期 时代 年代 民国 时光
位置 simility list : 位置
推出 simility list : 推出
详情 simility list : 详情
竞 simility list : 竞
骑士 simility list : 骑士
拍摄 simility list : 拍摄
库 simility list : 库
英雄 simility list : 英雄
苹果 simility list : 苹果
微笑 simility list : 微笑
期间 simility list : 期间
小时 simility list : 小时
声音 simility list : 声音
第四 simility list : 第四
方式 simility list : 方式
墓 simility list : 墓
听到 simility list : 听到
影视 simility list : 影视
创造 simility list : 创造
项目 simility list : 项目
表面 simility list : 表面
浓郁 simility list : 浓郁
遇 simility list : 遇
字幕 simility list : 字幕
家庭 simility list : 家庭
离婚 simility list : 离婚
财产 simility list : 财产 财物
大学 simility list : 大学 高校
顺利 simility list : 顺利
烹饪 simility list : 烹饪
军舰 simility list : 战斗机 舰船 舰艇 军舰
黄海 simility list : 黄海
超低空 simility list : 超低空
政府军 simility list : 海军 空军 陆军 政府军 特种部队
轻松 simility list : 轻松
指出 simility list : 表达 指出
小时候 simility list : 小时候
退役 simility list : 退役
退休 simility list : 退休
战场 simility list : 战场
回应 simility list : 回应
实用 simility list : 实用
最佳 simility list : 最佳
空中 simility list : 空中
年代 simility list : 时代 年代 民国
墙 simility list : 墙
标题 simility list : 标题
官方 simility list : 官方
湖南 simility list : 湖南
展示 simility list : 展示
抗战 simility list : 抗战
学者 simility list : 学者 作家
医生 simility list : 医生
骂 simility list : 骂
信息 simility list : 资讯 信息 消息
骑 simility list : 骑
预警 simility list : 预警
国产 simility list : 国产
理解 simility list : 理解
军方 simility list : 军方
现役 simility list : 现役
动力 simility list : 动力
贫困 simility list : 贫困
格 simility list : 格
运营 simility list : 运营
南海 simility list : 南海
猛 simility list : 猛
化身 simility list : 化身
侠 simility list : 侠
小品 simility list : 小品
年轮 simility list : 年轮
每周 simility list : 每周
花儿 simility list : 花儿
唱功 simility list : 唱功
扰 simility list : 扰
神曲 simility list : 神曲
用户 simility list : 用户
阶段 simility list : 阶段
情侣 simility list : 朋友 情侣
颗 simility list : 颗
银幕 simility list : 银幕
盲人 simility list : 盲人
黑帮 simility list : 黑帮
映 simility list : 映
消亡 simility list : 消亡
复活 simility list : 复活
电影院 simility list : 电影院
野蛮 simility list : 野蛮
温情 simility list : 温情 和平
客户 simility list : 客户
名将 simility list : 名将
出色 simility list : 出色 精彩 完美 优秀
同学 simility list : 同学
校园 simility list : 校园
全国 simility list : 全国
锋 simility list : 锋
主力 simility list : 主力
中场 simility list : 中场
星空 simility list : 空间 星空
能源 simility list : 能源
饭店 simility list : 饭店
沙漠 simility list : 沙漠
巴塞罗那 simility list : 巴塞罗那
热身 simility list : 热身
打入 simility list : 打入
替补 simility list : 替补
欧元 simility list : 欧元
主教练 simility list : 学生 主教练 大学生 老师
投手 simility list : 球员 投手
扑救 simility list : 扑救
击败 simility list : 击败
酒店 simility list : 酒店
消息 simility list : 资讯 信息 消息
厨 simility list : 厨
摄影 simility list : 摄影
小说 simility list : 小说
饿 simility list : 饿
湾 simility list : 湾
惊喜 simility list : 惊喜
宝宝 simility list : 宝宝 小孩
三明治 simility list : 三明治 饼干
粥 simility list : 粥 米饭
养生 simility list : 养生
鲜美 simility list : 可口 鲜美
奶油 simility list : 奶油
胃 simility list : 胃
煸 simility list : 煮 焖 煸 炖
蘸 simility list : 蘸
筋 simility list : 筋
蟹 simility list : 蟹
红烧 simility list : 红烧
零食 simility list : 零食
教程 simility list : 教程
火锅 simility list : 火锅
热量 simility list : 热量
酸奶 simility list : 酸奶
原料 simility list : 原料
饼干 simility list : 蛋糕 三明治 饼干
面粉 simility list : 面粉
菇 simility list : 菇
骨 simility list : 骨
页 simility list : 页
迎战 simility list : 迎战
领先 simility list : 领先
艺人 simility list : 演员 工人 艺人
水果 simility list : 水果
雨 simility list : 雨
区别 simility list : 区别
趋势 simility list : 趋势
内存 simility list : 引擎 内存 发动机
算法 simility list : 算法
零售 simility list : 零售
分布式 simility list : 分布式
监测 simility list : 监测
锤子 simility list : 锤子
超导体 simility list : 文物 超导体
程序员 simility list : 程序员
销量 simility list : 销量
商务 simility list : 商务
接受 simility list : 接受
炖 simility list : 煮 焖 煸 炖
终于 simility list : 终于
原因 simility list : 原因
带来 simility list : 带来
明年 simility list : 明年 去年
非法 simility list : 非法
百 simility list : 百 十
过程 simility list : 过程 始末
女子 simility list : 女子 女士
皇帝 simility list : 皇帝
伟 simility list : 伟
花絮 simility list : 花絮
裤子 simility list : 裤子
勿 simility list : 未 勿
下载 simility list : 下载
隐藏 simility list : 隐藏
去年 simility list : 明年 去年
新政 simility list : 新政
出行 simility list : 出行
聊天 simility list : 聊天
实施 simility list : 执行 实施
发表 simility list : 发表
精彩 simility list : 出色 精彩 完美 优秀
战国 simility list : 战国
忠 simility list : 忠
亮相 simility list : 亮相
慢慢 simility list : 慢慢
退出 simility list : 退出
快讯 simility list : 新闻 快讯
防守 simility list : 防守
特别 simility list : 特别
狼 simility list : 狼
始末 simility list : 过程 始末
西周 simility list : 西周
地域 simility list : 地区 地域
妃 simility list : 妃
孙中山 simility list : 孙中山
档案 simility list : 档案
考古 simility list : 科技 考古
官府 simility list : 官府
北宋 simility list : 北宋
千古 simility list : 千古
外国人 simility list : 外国人
计划 simility list : 计划
幻 simility list : 幻
面对 simility list : 面对
确认 simility list : 确认
鸡 simility list : 鸡
回忆 simility list : 回忆
风格 simility list : 风格
食堂 simility list : 食堂
完美 simility list : 出色 精彩 完美 优秀
瞬间 simility list : 瞬间
脑 simility list : 脑
场景 simility list : 场景
杀手 simility list : 杀手
进攻 simility list : 进攻
封面 simility list : 封面
飙 simility list : 飙
发动机 simility list : 引擎 内存 发动机
结局 simility list : 结局
科幻 simility list : 科幻
威胁 simility list : 威胁
引发 simility list : 导致 引发
商人 simility list : 商人
年轻人 simility list : 年轻人
福利 simility list : 福利
见面 simility list : 见面
魏 simility list : 魏
米饭 simility list : 粥 米饭
爱情 simility list : 爱情
最终 simility list : 最终
民国 simility list : 时代 年代 民国
应对 simility list : 应对
蓝色 simility list : 蓝色
出庭 simility list : 出庭
女士 simility list : 女子 女士
人群 simility list : 群众 人群 公众
溺水 simility list : 溺水
日报 simility list : 日报 杂志
服饰 simility list : 服饰
名字 simility list : 名字
世纪 simility list : 世纪
机场 simility list : 机场
事件 simility list : 事情 事件 事项
夫妻 simility list : 夫妻
诸多 simility list : 诸多 无数
上市 simility list : 上市
控制 simility list : 控制
深夜 simility list : 深夜 当晚
食物 simility list : 食物
专家 simility list : 专家
抵达 simility list : 抵达
成功 simility list : 成功
整理 simility list : 整理
外观 simility list : 外观
居民 simility list : 市民 居民
贵阳 simility list : 贵阳
有期徒刑 simility list : 有期徒刑
争执 simility list : 争执
索赔 simility list : 索赔
开通 simility list : 开通
市长 simility list : 总统 主席 队长 市长 院长 总理
事项 simility list : 事件 事项
伤亡 simility list : 伤亡
通车 simility list : 通车
事后 simility list : 事后
措施 simility list : 方法 措施 办法
碍 simility list : 碍
交警 simility list : 交警
急救 simility list : 急救
言论 simility list : 言论
南昌 simility list : 南昌
下月 simility list : 下月
国事访问 simility list : 国事访问
莎 simility list : 莎
涉嫌 simility list : 涉嫌
烧毁 simility list : 烧毁
脱贫 simility list : 脱贫
列车 simility list : 列车 轿车 摩托车
海南 simility list : 海南
院长 simility list : 总统 主席 队长 市长 院长 总理
公安部 simility list : 公安部
财物 simility list : 财产 财物
村民 simility list : 村民
宣传部 simility list : 宣传部
行驶 simility list : 行驶
至少 simility list : 至少
失控 simility list : 失控
头部 simility list : 头部
公安 simility list : 公安
查明 simility list : 查明
护 simility list : 护
拼 simility list : 拼
违章 simility list : 违章
制定 simility list : 制定
监控 simility list : 监控
主任 simility list : 总统 主席 队长 主任 总理 负责人
讨论 simility list : 讨论
失踪 simility list : 失踪
应急 simility list : 应急
轿车 simility list : 列车 轿车 摩托车
懂 simility list : 懂
结构 simility list : 结构
和平 simility list : 温情 和平
大学生 simility list : 主教练 大学生 老师
刚刚 simility list : 刚刚
先进 simility list : 先进
记载 simility list : 记载
出土 simility list : 出土
永远 simility list : 永远
莉 simility list : 莉
北 simility list : 北
迎来 simility list : 迎来
继 simility list : 继
榜 simility list : 榜
游客 simility list : 乘客 游客
机构 simility list : 机构
云南 simility list : 云南
功能 simility list : 功能
速度 simility list : 速度
暂 simility list : 暂
细节 simility list : 细节
激情 simility list : 激情
可怕 simility list : 可怕
合肥 simility list : 合肥
回家 simility list : 回家
提名 simility list : 提名
设备 simility list : 设备
提供 simility list : 提供
时隔 simility list : 时隔
道理 simility list : 道理
每日 simility list : 每日
摄影师 simility list : 摄影师
人生 simility list : 人生
股份 simility list : 股份 资金
香港 simility list : 香港
撬 simility list : 撬
常州 simility list : 常州
能量 simility list : 能量
合法 simility list : 合法
路线 simility list : 路线
银行 simility list : 银行
晚上 simility list : 晚上
摩托车 simility list : 列车 轿车 摩托车
牌照 simility list : 牌照
好友 simility list : 朋友 好友
原理 simility list : 原理
专访 simility list : 专访
新疆 simility list : 新疆
中午 simility list : 下午 中午
煤炭 simility list : 煤炭
公安局 simility list : 法院 警方 公安局
求助 simility list : 求助
总理 simility list : 总统 队长 市长 院长 主任 总理 负责人
语言 simility list : 语言
高校 simility list : 大学 高校
制作 simility list : 制作
来源 simility list : 来源
图片 simility list : 地图 图片
打电话 simility list : 打电话
主办 simility list : 主办
当晚 simility list : 深夜 当晚
通报 simility list : 通报
创始人 simility list : 创始人
亮点 simility list : 亮点
兴趣 simility list : 口味 兴趣
昨晚 simility list : 昨晚
火力 simility list : 火力
内容 simility list : 内容
销售 simility list : 销售
偷偷 simility list : 偷偷
价格 simility list : 价格
相约 simility list : 相约
付出 simility list : 付出
战术 simility list : 战术
唯 simility list : 唯
母亲 simility list : 爸爸 母亲 妈妈
火箭 simility list : 导弹 火箭
频道 simility list : 频道
配音 simility list : 配音
面积 simility list : 面积
潜艇 simility list : 战斗机 潜艇
巡航 simility list : 巡航
防空 simility list : 防空
参战 simility list : 参战
核动力 simility list : 核动力
联军 simility list : 海军 空军 陆军 联军 特种部队
步枪 simility list : 步枪
飞行员 simility list : 司机 飞行员
原子弹 simility list : 原子弹
中程 simility list : 中程
演习 simility list : 演习
试验 simility list : 试验
装甲 simility list : 装甲
我军 simility list : 海军 空军 陆军 我军 特种部队
特种部队 simility list : 政府军 联军 我军 特种部队
出征 simility list : 出征
白搭 simility list : 白搭
战役 simility list : 战役
等待 simility list : 等待
宣传 simility list : 宣传
桥 simility list : 桥
帧 simility list : 帧
增长 simility list : 增长
开国 simility list : 开国
广东 simility list : 广东
心中 simility list : 心中
评价 simility list : 评价
碰撞 simility list : 碰撞
抵抗 simility list : 抵抗
小孩 simility list : 宝宝 小孩
算是 simility list : 算是
广场 simility list : 广场
首都 simility list : 首都
告诉 simility list : 告诉
武汉 simility list : 武汉
公交 simility list : 公交
社交 simility list : 社交
调整 simility list : 调整
负责人 simility list : 总统 主席 队长 主任 总理 负责人
来到 simility list : 来到
演示 simility list : 演示
全新 simility list : 全新
时光 simility list : 机会 时期 时代 时光
美元 simility list : 美元
好久 simility list : 好久
周年 simility list : 周年
举办 simility list : 举办
深圳 simility list : 深圳
纪录片 simility list : 纪录片
核潜艇 simility list : 战斗机 驱逐舰 航母 核潜艇
谴责 simility list : 谴责
盟军 simility list : 盟军
升级 simility list : 升级
早晨 simility list : 早晨
利益 simility list : 利益
十 simility list : 百 十
到来 simility list : 到来
鹰 simility list : 鹰
沪 simility list : 沪
烦恼 simility list : 烦恼
好像 simility list : 好像
今日 simility list : 昨日 今日
杂志 simility list : 日报 杂志
蔬菜 simility list : 蔬菜
河南 simility list : 河南
找到 simility list : 找到
签署 simility list : 签署
选择 simility list : 选择
日军 simility list : 日军
优秀 simility list : 出色 精彩 完美 优秀
公众 simility list : 群众 人群 公众
承担 simility list : 承担
意志 simility list : 意志
著名 simility list : 著名
俩 simility list : 俩
透露 simility list : 透露
基地 simility list : 基地
国外 simility list : 国外
城市 simility list : 城市
毕业 simility list : 毕业
曝 simility list : 曝
上周 simility list : 上周
担心 simility list : 担心
主题 simility list : 主题
正确 simility list : 正确
最初 simility list : 最初
儿子 simility list : 儿子
救援 simility list : 救援
资金 simility list : 股份 资金
航天 simility list : 航天
条例 simility list : 条例
流血 simility list : 流血
符合 simility list : 符合
联盟 simility list : 联盟
真相 simility list : 真相
流浪 simility list : 流浪
领衔 simility list : 领衔
喜爱 simility list : 恋 喜爱
撒娇 simility list : 撒娇
性感 simility list : 性感
荣获 simility list : 荣获
体验 simility list : 体验
偶像 simility list : 偶像
妮 simility list : 妮
万万 simility list : 万万
现状 simility list : 现状
探险 simility list : 探险
整体 simility list : 整体
潘 simility list : 潘
大胆 simility list : 大胆
砍 simility list : 砍
太 simility list : 太
热烈 simility list : 热烈
作家 simility list : 学者 作家
剧照 simility list : 剧照
影迷 simility list : 影迷
魅力 simility list : 魅力
入侵 simility list : 入侵
剧场 simility list : 剧场
闫 simility list : 闫
泪 simility list : 泪
穿越 simility list : 穿越
自我 simility list : 自我
办法 simility list : 方法 措施 办法
无数 simility list : 诸多 无数
阴影 simility list : 阴影
有限公司 simility list : 有限公司
恭喜 simility list : 恭喜
全员 simility list : 全员
媳妇 simility list : 媳妇
妈妈 simility list : 爸爸 母亲 妈妈
年龄 simility list : 年龄
村 simility list : 村
老婆 simility list : 妻子 丈夫 老婆
空气 simility list : 空气
含义 simility list : 含义
持续 simility list : 持续
老师 simility list : 学生 主教练 大学生 老师
巅峰 simility list : 巅峰
续集 simility list : 续集
晚安 simility list : 晚安
思考 simility list : 思考
有时候 simility list : 有时候
心目 simility list : 心目
做客 simility list : 做客
洛 simility list : 洛
选手 simility list : 选手
登场 simility list : 登场
为期 simility list : 为期
内蒙古 simility list : 内蒙古
学习 simility list : 学习
