电影 similarity attribute list is : 影片 动画 
简单 similarity attribute list is : 详细 
新闻 similarity attribute list is : 快讯 
海军 similarity attribute list is : 空军 军队 陆军 
球员 similarity attribute list is : 投手 
导弹 similarity attribute list is : 火箭 
战斗机 similarity attribute list is : 驱逐舰 坦克 航母 舰船 舰艇 军舰 潜艇 核潜艇 
煮 similarity attribute list is : 焖 煸 炖 
企业 similarity attribute list is : 店 
法院 similarity attribute list is : 警方 公安局 
军人 similarity attribute list is : 士兵 
博物馆 similarity attribute list is : 博物院 
司机 similarity attribute list is : 飞行员 
期待 similarity attribute list is : 希望 
昨日 similarity attribute list is : 今日 
驾 similarity attribute list is : 驾驶 
爸爸 similarity attribute list is : 母亲 妈妈 
文物 similarity attribute list is : 超导体 
书记 similarity attribute list is : 员工 
周五 similarity attribute list is : 周四 周六 
地图 similarity attribute list is : 图片 
妻子 similarity attribute list is : 丈夫 老婆 
战士 similarity attribute list is : 新兵 
豆腐 similarity attribute list is : 鸡肉 牛肉 
引擎 similarity attribute list is : 内存 发动机 
年货 similarity attribute list is : 产品 
哥哥 similarity attribute list is : 哥 
地区 similarity attribute list is : 地域 
朋友 similarity attribute list is : 情侣 好友 
赶到 similarity attribute list is : 前往 
父母 similarity attribute list is : 家长 
国家 similarity attribute list is : 区 县 
导致 similarity attribute list is : 引发 
群众 similarity attribute list is : 人群 公众 
执行 similarity attribute list is : 实施 
空间 similarity attribute list is : 星空 
未 similarity attribute list is : 勿 
科技 similarity attribute list is : 人工智能 考古 
主席 similarity attribute list is : 主持人 
下午 similarity attribute list is : 中午 
口味 similarity attribute list is : 兴趣 
可口 similarity attribute list is : 鲜美 
恋 similarity attribute list is : 喜爱 
表达 similarity attribute list is : 指出 
方法 similarity attribute list is : 措施 办法 
队长 similarity attribute list is : 总统 市长 院长 主任 总理 负责人 
市民 similarity attribute list is : 居民 
救人 similarity attribute list is : 救命 
资讯 similarity attribute list is : 信息 消息 
乘客 similarity attribute list is : 游客 
时代 similarity attribute list is : 时期 年代 民国 
财产 similarity attribute list is : 财物 
大学 similarity attribute list is : 高校 
学者 similarity attribute list is : 作家 
温情 similarity attribute list is : 和平 
出色 similarity attribute list is : 精彩 完美 优秀 
主教练 similarity attribute list is : 学生 大学生 老师 
宝宝 similarity attribute list is : 小孩 
粥 similarity attribute list is : 米饭 
饼干 similarity attribute list is : 蛋糕 三明治 
艺人 similarity attribute list is : 演员 工人 
明年 similarity attribute list is : 去年 
百 similarity attribute list is : 十 
过程 similarity attribute list is : 始末 
女子 similarity attribute list is : 女士 
日报 similarity attribute list is : 杂志 
事件 similarity attribute list is : 事情 事项 
诸多 similarity attribute list is : 无数 
深夜 similarity attribute list is : 当晚 
列车 similarity attribute list is : 轿车 摩托车 
股份 similarity attribute list is : 资金 
时光 similarity attribute list is : 机会 时期 
总近义词数目：184
约减后列表数目 : 72